file_name,accuracy,tn,fp,fn,tp,precision,recall,f1,annot_fg,annot_bg,area_true,area_pred,area_error,seg_time,model_name,annot_duration_s,clicks
1890990 Resistivity-Gamma-Directional Survey Log Scan_003.jpg,0.9968906168419482,221433,512,822,206257,0.997523806760201,0.9960305004370312,0.9967765943051555,1158,1417,207079,206769,-310,1747219499.0,000065_1747476517.pkl,203.9361550807953,30
1920280_M-26A_Density Log Scan_Color_004.jpg,0.9971889040516492,249328,905,504,250491,0.9964001018313736,0.9979919918723481,0.9971954115420062,835,2298,250995,251396,401,1747219681.0,000001_1747219499.pkl,248.03662753105164,48
T19982 Stage1Jewelry_16JUL10_004.jpg,0.9993328133201859,224120,79,193,183290,0.99956917472419,0.9989481314345198,0.9992585565841265,230,363,183483,183369,-114,1747219999.0,000001_1747219499.pkl,232.78043293952942,47
|1920200 Dual Prop, Resistivity, Gamma, Directional Log Scan_000.jpg|,0.9994653609397961,573155,340,26,111053,0.9969477435745514,0.9997659323544504,0.998354849149556,1196,1805,111079,111393,314,1747220265.0,000010_1747220262.pkl,0,0
1860310 Gamma Ray Log Scan 3_001.jpg,0.9997695015373076,337328,98,20,174488,0.9994386720584697,0.9998853920737159,0.999661982159533,615,700,174508,174586,78,1747220672.0,000012_1747220308.pkl,120.58772683143616,21
$R14BIPP_004.jpg,0.999964929262322,335087,9,6,92605,0.9999028224674456,0.9999352128796796,0.9999190174112565,567,124,92611,92614,3,1747220814.0,000016_1747220792.pkl,327.3504958152771,72
CD3-130PB1 VISION Resistivity 5MD Recorded Mode Log_002.jpg,1.0,627384,0,0,166497,1.0,1.0,1.0,0,0,166497,166497,0,1747221140.0,000021_1747221067.pkl,0,0
1860310 Gamma Ray Log Scan 4_004.jpg,1.0,385214,0,0,120976,1.0,1.0,1.0,0,0,120976,120976,0,1747221166.0,000021_1747221067.pkl,7.134925603866577,0
1860310 Gamma Ray Log Scan 3_004.jpg,1.0,376589,0,0,135345,1.0,1.0,1.0,0,0,135345,135345,0,1747221174.0,000021_1747221067.pkl,8.170525789260864,0
1770670 Core Gamma Correlation Scan_003.jpg,1.0,352632,0,0,91548,1.0,1.0,1.0,0,0,91548,91548,0,1747221183.0,000022_1747221182.pkl,11.907095670700073,0
1780180 PRUDHOE BAY UNIT 04-12 TEMP LOG_003.jpg,0.8280859570214892,359096,76312,56,8758,0.1029505113435994,0.9936464715225777,0.18657066166758982,292,412929,8814,85070,76256,1747221194.0,000022_1747221182.pkl,1328.0916149616241,290
SCU 31-04 PB1 TC TVD_003.jpg,0.8783229061795867,525370,80470,748,60900,0.4307844662941218,0.9878665974565274,0.5999468027465544,1426,301183,61648,141370,79722,1747222605.0,000023_1747221274.pkl,2568.2845709323883,580
1630230 Sonic Log-Gamma Ray Scan_000.jpg,1.0,506116,0,0,112466,1.0,1.0,1.0,0,0,112466,112466,0,1747225222.0,000023_1747221274.pkl,0,0
1961900 Core Gamma Log Scan_001.jpg,0.6419329131348258,245081,148140,132,20737,0.12279351243804662,0.9936748286932771,0.21857641267800113,241,332547,20869,168877,148008,1747298008.0,000023_1747221274.pkl,483.5223512649536,77
1900770 Resistivity-Gamma-Dual Prop Survey Scan_003.jpg,0.9821355356410707,649351,12135,65,21369,0.637804441260745,0.9969674349164879,0.7779314864028543,176,127761,21434,33504,12070,1747298548.0,000031_1747298526.pkl,1295.4406428337097,258
1890990 Resistivity-Gamma-Directional Survey Log Scan_002.jpg,0.9855346087864548,411167,4576,1630,11651,0.7180008627595982,0.8772682779911152,0.7896841534499119,3422,232809,13281,16227,2946,1747302007.0,000035_1747299080.pkl,788.8989732265472,180
CD3-130PB1 VISION Resistivity 5MD Recorded Mode Log_000.jpg,0.990653511042587,778333,1650,5770,8128,0.8312538351401104,0.5848323499784142,0.6866024666328772,5930,4892,13898,9778,-4120,1747303276.0,000037_1747302240.pkl,3303.250124692917,605
3H-33A_LDL_10DEC23_img_004.jpg,0.9801515783618412,698615,1457,12816,6212,0.8100143434606859,0.3264662602480555,0.46537064089598085,13181,3150,19028,7669,-11359,1747307110.0,000037_1747302240.pkl,3392.2495017051697,782
|1930330 Dual Prop, Resistivity, Gamma Ray Log Scan_002.jpg|,1.0,421969,0,0,6395,1.0,1.0,1.0,0,0,6395,6395,0,1747331075.0,000037_1747302240.pkl,0,0
|1930650 Dual Prop, Resistivity, Gamma Ray Log B&W_003.jpg|,1.0,418459,0,0,9248,1.0,1.0,1.0,0,0,9248,9248,0,1747342053.0,000042_1747333285.pkl,0,0
|1920380 Dual Prop, Resistivity, Gamma Ray Log Scan_002.jpg|,0.9951228294135939,414693,2021,65,10928,0.8439261719051664,0.9940871463658691,0.9128727758750314,119,98159,10993,12949,1956,1747342074.0,000042_1747333285.pkl,0,0
CD3-130 PB2  EcoScope 2TVD Recorded Mode Log_004.jpg,0.979310501196023,745808,10239,6186,31648,0.7555566166113591,0.8364962731934239,0.793968966771616,6898,44131,37834,41887,4053,1747342325.0,000043_1747342253.pkl,3960.8227598667145,851
1860310 Gamma Ray Log Scan 4_003.jpg,1.0,499878,0,0,6312,1.0,1.0,1.0,0,0,6312,6312,0,1747346906.0,000045_1747342394.pkl,0,0
ODSN-24 PB1 2in TVD_001.jpg,1.0,664503,0,0,7896,1.0,1.0,1.0,0,0,7896,7896,0,1747401920.0,000045_1747342394.pkl,0,0
T19972 LDL_04AUG10_003.jpg,0.9958087966136255,399894,515,1191,5443,0.913561597851628,0.8204703044920109,0.8645171537484118,1694,635,6634,5958,-676,1747401988.0,000045_1747342394.pkl,1084.2850785255432,224
1770670 Core Gamma Correlation Scan_002.jpg,1.0,437956,0,0,6224,1.0,1.0,1.0,0,0,6224,6224,0,1747403161.0,000045_1747342394.pkl,7.443857669830322,0
1860310 Gamma Ray Log Scan_001.jpg,0.9860144861316943,490260,6912,128,6078,0.4678983833718245,0.9793747985820174,0.6332569285267764,154,39600,6206,12990,6784,1747403169.0,000045_1747342394.pkl,256.62580585479736,65
1900740 Resistivity-Gamma-Directional Survey Scan_003.jpg,0.9880425752486988,410491,269,4783,6956,0.9627681660899654,0.5925547320896158,0.733600506222316,5214,4690,11739,7225,-4514,1747403627.0,000045_1747342394.pkl,663.6951296329498,114
1920280_M-26A_Density Log Scan_Color_001.jpg,0.9934441012872386,494012,168,3118,3930,0.95900439238653,0.5576049943246311,0.7051857168490937,3242,769,7048,4098,-2950,1747404388.0,000047_1747403780.pkl,714.7675683498383,135
|1930330 Dual Prop, Resistivity, Gamma Ray Log Scan_000.jpg|,0.9988864610471468,414228,477,0,13659,0.9662563667232598,1.0,0.9828386400431732,0,907,13659,14136,477,1747407380.0,000051_1747405273.pkl,0,0
|1920270 Density, Porosity, Resistivity, Gamma Ray Log Scan B&W_001.jpg|,0.9958780192982579,406135,1470,293,19809,0.9309178062878894,0.9854243358869764,0.9573959063338247,339,9870,20102,21279,1177,1747407792.0,000051_1747405273.pkl,0,0
T19980 LDL_01AUG10_001.jpg,1.0,722647,0,0,2403,1.0,1.0,1.0,0,0,2403,2403,0,1747408866.0,000051_1747405273.pkl,16.140342950820923,0
1780180 PRUDHOE BAY UNIT 04-12 TEMP LOG_004.jpg,0.9593626610118364,411568,16733,1319,14602,0.46599648954842826,0.9171534451353558,0.6179955984425257,1443,256833,15921,31335,15414,1747408876.0,000051_1747405273.pkl,465.71354699134827,82
|1921440 Dual Prop, Resistivity, Gamma Ray Log Scan_003.jpg|,0.9938769744323915,401285,1440,1139,17333,0.9232940925797688,0.9383391078388913,0.9307558061484763,1242,8725,18472,18773,301,1747409471.0,000052_1747409113.pkl,0,0
1920280_M-26A_Density-Neutron Log Scan_Color_000.jpg,1.0,392751,0,0,11097,1.0,1.0,1.0,0,0,11097,11097,0,1747410078.0,000054_1747409655.pkl,12.033058166503906,0
CD3-130PB1 VISION Resistivity 5MD Recorded Mode Log_004.jpg,1.0,745554,0,0,48327,1.0,1.0,1.0,0,0,48327,48327,0,1747410089.0,000054_1747409655.pkl,11.263425827026367,0
1860310 Gamma Ray Log Scan 4_002.jpg,1.0,506140,0,0,50,1.0,1.0,1.0,0,0,50,50,0,1747410097.0,000054_1747409655.pkl,5.050790071487427,0
1890990 Resistivity-Gamma-Directional Survey Log Scan_000.jpg,0.9999696986648765,420558,13,0,8453,0.9984644460193716,1.0,0.9992316330752409,0,24,8453,8466,13,1747410105.0,000054_1747409655.pkl,17.13320827484131,1
T19982 PlugSetting_03JUL10_003.jpg,0.9963911525029103,726631,2000,635,884,0.3065187239944521,0.5819618169848585,0.4015444015444016,1407,66569,1519,2884,1365,1747410151.0,000054_1747409655.pkl,252.77528977394104,63
|1930340 Dual Prop, Resistivity, Density, Gamma Ray Log Scan_001.jpg|,0.996633209182922,415895,1127,313,10372,0.9019914775197844,0.970706598034628,0.9350883519653805,405,46133,10685,11499,814,1747410428.0,000054_1747409655.pkl,0,0
SCU 31-04 PB1 TC TVD_000.jpg,0.9901661153458938,650996,3902,2662,9928,0.7178597252349964,0.7885623510722796,0.751551854655564,3153,21792,12590,13830,1240,1747410989.0,000054_1747409655.pkl,520.3647797107697,98
|1930430 Dual Prop, Resistivity, Gamma Ray Log Scan_000.jpg|,1.0,422461,0,0,5246,1.0,1.0,1.0,0,0,5246,5246,0,1747414900.0,000062_1747414633.pkl,0,0
1860310 Gamma Ray Log Scan 3_002.jpg,0.99523962073236,502638,59,2378,6859,0.9914715235617231,0.7425571072859153,0.8491488703187867,2627,111,9237,6918,-2319,1747414912.0,000062_1747414633.pkl,677.9065618515015,147
1640150 ITKILLIK UNIT 1 TEMP LOG_001.jpg,1.0,442890,0,0,0,nan,nan,nan,0,0,0,0,0,1747477454.0,000065_1747476517.pkl,14.235256433486938,0
|1910880 Resistivity, Gamma, Directional Survey Log Scan_000.jpg|,0.9950188201357864,420598,1958,166,3683,0.6528984222655557,0.9568719147830606,0.7761854583772392,183,17029,3849,5641,1792,1747477470.0,000065_1747476517.pkl,0,0
|1920950 Dual Prop, Resistivity, Gamma Ray Log Scan_002.jpg|,0.9948505258182677,406903,0,2179,14068,1.0,0.8658829322336431,0.9281213920501401,2523,0,16247,14068,-2179,1747478235.0,000065_1747476517.pkl,0,0
|1920200 Dual Prop, Resistivity, Gamma, Directional Log Scan_003.jpg|,0.9990096030524093,659308,92,586,24588,0.9962722852512156,0.976722014777151,0.9864002888434229,753,154,25174,24680,-494,1747478637.0,000065_1747476517.pkl,0,0
CD3-130 PB2  EcoScope 2MD Recorded Mode Log_002.jpg,0.9958318690080755,764177,458,2851,26395,0.9829441775593044,0.9025165834644054,0.9410149913545696,3260,2825,29246,26853,-2393,1747478905.0,000065_1747476517.pkl,1051.3988745212555,189
MPU_B-19A_JEWELRY_26FEB24_img_004.jpg,1.0,722994,0,0,3756,1.0,1.0,1.0,0,0,3756,3756,0,1747480072.0,000065_1747476517.pkl,10.548861265182495,0
|1930430 Dual Prop, Resistivity, Gamma Ray Log Scan_004.jpg|,1.0,423348,0,0,4359,1.0,1.0,1.0,0,0,4359,4359,0,1747480082.0,000065_1747476517.pkl,0,0
1920280_M-26A_Density-Neutron Log Scan_Color_004.jpg,1.0,388431,0,0,15417,1.0,1.0,1.0,0,0,15417,15417,0,1747480092.0,000065_1747476517.pkl,0,0
|1920370 Dual Prop, Resistivity, Gamma Ray Log Scan_004.jpg|,0.9980368979591837,755664,399,1104,8458,0.9549508863046178,0.8845429826396152,0.918399478799066,1444,5479,9562,8857,-705,1747480440.0,000065_1747476517.pkl,0,0
|1920950 Dual Prop, Resistivity, Gamma Ray Log Scan_004.jpg|,0.9921824412146992,419482,1410,1898,360,0.2033898305084746,0.15943312666076173,0.1787487586891758,2064,20454,2258,1770,-488,1747480661.0,000065_1747476517.pkl,0,0
|1920370 Dual Prop, Resistivity, Gamma Ray Log Scan_001.jpg|,0.9918994285714285,743280,442,5760,16143,0.973349412119385,0.737022325708807,0.8388588651008106,6981,1264,21903,16585,-5318,1747480917.0,000065_1747476517.pkl,0,0
|1921440 Dual Prop, Resistivity, Gamma Ray Log Scan_002.jpg|,1.0,414523,0,0,6674,1.0,1.0,1.0,0,0,6674,6674,0,1747481719.0,000065_1747476517.pkl,0,0
1920280_M-26A_Density-Neutron Log Scan_Color_001.jpg,0.9932028882153682,390309,2196,549,10794,0.8309468822170901,0.9516001057921185,0.887190235482678,628,28100,11343,12990,1647,1747647136.0,000065_1747476517.pkl,700.8000428676605,135
CD3-130 PB2  EcoScope 2MD Recorded Mode Log_003.jpg,1.0,783180,0,0,10701,1.0,1.0,1.0,0,0,10701,10701,0,1747647837.0,000065_1747476517.pkl,0,0
1860310 Gamma Ray Log Scan 3_000.jpg,1.0,511021,0,0,913,1.0,1.0,1.0,0,0,913,913,0,1747647858.0,000065_1747476517.pkl,7.519675970077515,0
1920280_M-26A_Density Log Scan_Color_003.jpg,1.0,467749,0,0,33479,1.0,1.0,1.0,0,0,33479,33479,0,1747647866.0,000065_1747476517.pkl,7.670749664306641,0
1900740 Resistivity-Gamma-Directional Survey Scan_000.jpg,0.9970887505059184,420444,0,1230,825,1.0,0.40145985401459855,0.5729166666666666,1374,0,2055,825,-1230,1747647874.0,000065_1747476517.pkl,617.8895418643951,125
1801120 Gamma Ray Plot Scan_001.jpg,0.9994047192139425,557380,109,223,8,0.06837606837606838,0.03463203463203463,0.04597701149425288,223,1103,231,117,-114,1747648545.0,000065_1747476517.pkl,117.85165810585022,12
1900740 Resistivity-Gamma-Directional Survey Scan_001.jpg,0.9989325418521701,408514,282,169,13534,0.9795888824551245,0.9876669342479749,0.9836113230858679,217,513,13703,13816,113,1747648663.0,000065_1747476517.pkl,439.9566261768341,70
1920280_M-26A_Density Log Scan_Color_000.jpg,1.0,493365,0,0,7863,1.0,1.0,1.0,0,0,7863,7863,0,1747649175.0,000065_1747476517.pkl,19.78449034690857,0
CD3-130PB1 VISION Resistivity 2TVD Recorded Mode Log_003.jpg,0.9918778759033154,765433,1101,5347,22000,0.9523397255530064,0.8044758108750503,0.8721852204249921,5766,1818,27347,23101,-4246,1747649195.0,000065_1747476517.pkl,2834.338988304138,556
2002170_PBU 02-03B_Gamma Ray Log Scan (TVD)_004.jpg,0.9963594000291248,423880,0,1550,324,1.0,0.1728922091782284,0.2948134667879891,1607,0,1874,324,-1550,1747652113.0,000066_1747650154.pkl,173.1206591129303,24
|1930650 Dual Prop, Resistivity, Gamma Ray Log B&W_000.jpg|,0.989780387040661,401559,2031,2340,21777,0.9146925403225806,0.9029730065928598,0.9087949921752739,2749,2644,24117,23808,-309,1747652315.0,000066_1747650154.pkl,0,0
1890990 Resistivity-Gamma-Directional Survey Log Scan_004.jpg,0.9970048295666443,426575,0,1285,1164,1.0,0.47529603919967334,0.6443398837531137,1434,0,2449,1164,-1285,1747654040.0,000066_1747650154.pkl,192.25377655029297,22
$R14BIPP_000.jpg,0.9975941473952963,412904,363,666,13774,0.9743226992997099,0.9538781163434903,0.9639920215557966,779,605,14440,14137,-303,1747654635.0,000066_1747650154.pkl,253.55786275863647,38
|1920380 Dual Prop, Resistivity, Gamma Ray Log Scan_000.jpg|,1.0,427067,0,0,640,1.0,1.0,1.0,0,0,640,640,0,1747654909.0,000066_1747650154.pkl,0,0
|1921440 Dual Prop, Resistivity, Gamma Ray Log Scan_001.jpg|,0.9835896267067429,397667,3494,3418,16618,0.8262728719172633,0.829407067278898,0.8278370030885721,3969,21137,20036,20112,76,1747654934.0,000066_1747650154.pkl,0,0
SCU 31-04 PB1 TC TVD_002.jpg,0.994671065247615,635434,0,3557,28497,1.0,0.8890310101703376,0.9412561311951908,4234,0,32054,28497,-3557,1747655740.0,000066_1747650154.pkl,325.1759030818939,46
ODSN-24 PB1 2in TVD_002.jpg,1.0,672399,0,0,0,nan,nan,nan,0,0,0,0,0,1747656098.0,000066_1747650154.pkl,0,0
|1930340 Dual Prop, Resistivity, Density, Gamma Ray Log Scan_003.jpg|,1.0,417886,0,0,9821,1.0,1.0,1.0,0,0,9821,9821,0,1747656128.0,000066_1747650154.pkl,0,0
T19978 PPROF_23JUL10_003.jpg,1.0,404554,0,0,1215,1.0,1.0,1.0,0,0,1215,1215,0,1747656138.0,000066_1747650154.pkl,10.077253818511963,0
|1921440 Dual Prop, Resistivity, Gamma Ray Log Scan_004.jpg|,0.9949975902012598,382218,990,1117,36872,0.9738524113887275,0.970596751691279,0.9722218560071719,1467,1485,37989,37862,-127,1747656148.0,000066_1747650154.pkl,0,0
1640150 ITKILLIK UNIT 1 TEMP LOG_002.jpg,1.0,428974,0,0,13916,1.0,1.0,1.0,0,0,13916,13916,0,1747656538.0,000066_1747650154.pkl,11.443182945251465,0
1860310 Gamma Ray Log Scan_003.jpg,0.996676453877603,488026,759,914,13679,0.9474303920210555,0.9373672308641129,0.9423719472288243,990,10032,14593,14438,-155,1747656549.0,000066_1747650154.pkl,254.24522590637207,41
CD3-130PB1 VISION Resistivity 2TVD Recorded Mode Log_000.jpg,0.9895047242596813,748528,5139,3193,37021,0.8781072106261859,0.9205997911175212,0.8988515793818437,3427,9256,40214,42160,1946,1747656803.0,000066_1747650154.pkl,1370.1247310638428,235
1900770 Resistivity-Gamma-Dual Prop Survey Scan_004.jpg,1.0,673757,0,0,9163,1.0,1.0,1.0,0,0,9163,9163,0,1747658251.0,000066_1747650154.pkl,11.598695516586304,0
|1901260 R, Gamma, Directional Log Scan_002.jpg|,1.0,409458,0,0,17598,1.0,1.0,1.0,0,0,17598,17598,0,1747658263.0,000067_1747658258.pkl,0,0
2002170_PBU 02-03B_Gamma Ray Log Scan (TVD)_001.jpg,1.0,417225,0,0,8529,1.0,1.0,1.0,0,0,8529,8529,0,1747658279.0,000067_1747658258.pkl,0,0
CD3-130 PB2  EcoScope 2TVD Recorded Mode Log_001.jpg,1.0,755407,0,0,38474,1.0,1.0,1.0,0,0,38474,38474,0,1747658321.0,000068_1747658283.pkl,6.426642656326294,0
CD3-130PB1 VISION Resistivity 2TVD Recorded Mode Log_002.jpg,1.0,759645,0,0,34236,1.0,1.0,1.0,0,0,34236,34236,0,1747658329.0,000068_1747658283.pkl,7.825279235839844,0
|1910880 Resistivity, Gamma, Directional Survey Log Scan_002.jpg|,1.0,416273,0,0,10132,1.0,1.0,1.0,0,0,10132,10132,0,1747658337.0,000068_1747658283.pkl,0,0
1920280_M-26A_Density-Neutron Log Scan_Color_002.jpg,1.0,399964,0,0,3884,1.0,1.0,1.0,0,0,3884,3884,0,1747658349.0,000068_1747658283.pkl,9.389073133468628,0
|1920370 Dual Prop, Resistivity, Gamma Ray Log Scan_002.jpg|,0.999617306122449,763923,293,0,1409,0.8278495887191539,1.0,0.9058180649308903,0,4838,1409,1702,293,1747658357.0,000068_1747658283.pkl,0,0
|1901260 R, Gamma, Directional Log Scan_003.jpg|,1.0,426954,0,0,102,1.0,1.0,1.0,0,0,102,102,0,1747658409.0,000068_1747658283.pkl,0,0
|1930430 Dual Prop, Resistivity, Gamma Ray Log Scan_003.jpg|,0.9942133282831471,404353,346,2129,20879,0.983698468786808,0.9074669680111266,0.9440463002735513,2316,856,23008,21225,-1783,1747658421.0,000068_1747658283.pkl,0,0
|1930270 Dual Prop, Resistivity, Gamma Ray Log Scan_001.jpg|,0.9995821310847783,419039,7,172,9146,0.9992352234240139,0.9815411032410388,0.9903091332358832,201,19,9318,9153,-165,1747658796.0,000069_1747658457.pkl,0,0
CD3-130 PB2  EcoScope 2MD Recorded Mode Log_000.jpg,0.9894543388744661,763020,8372,0,22489,0.728719095298273,1.0,0.8430740393626992,0,72918,22489,30861,8372,1747658886.0,000069_1747658457.pkl,607.0035810470581,134
|1920370 Dual Prop, Resistivity, Gamma Ray Log Scan_000.jpg|,1.0,765323,0,0,302,1.0,1.0,1.0,0,0,302,302,0,1747659493.0,000069_1747658457.pkl,0,0
1801120 Gamma Ray Plot Scan_003.jpg,1.0,557720,0,0,0,nan,nan,nan,0,0,0,0,0,1747659506.0,000069_1747658457.pkl,13.658915758132935,0
|1920380 Dual Prop, Resistivity, Gamma Ray Log Scan_001.jpg|,1.0,418466,0,0,9241,1.0,1.0,1.0,0,0,9241,9241,0,1747659519.0,000069_1747658457.pkl,0,0
CD3-130PB1 VISION Resistivity 2TVD Recorded Mode Log_004.jpg,1.0,780051,0,0,13830,1.0,1.0,1.0,0,0,13830,13830,0,1747659527.0,000069_1747658457.pkl,8.92109751701355,0
|1930330 Dual Prop, Resistivity, Gamma Ray Log Scan_001.jpg|,0.9998505943543342,419602,55,9,8698,0.9937164400776877,0.9989663489146664,0.9963344788087057,19,209,8707,8753,46,1747659536.0,000070_1747659531.pkl,0,0
1640150 ITKILLIK UNIT 1 TEMP LOG_004.jpg,0.9952787373840005,438384,2091,0,2415,0.5359520639147803,1.0,0.6978760294755093,0,60120,2415,4506,2091,1747659646.0,000071_1747659556.pkl,53.28436851501465,8
1900740 Resistivity-Gamma-Directional Survey Scan_004.jpg,0.9984118305605457,413098,178,493,8730,0.9800179613830265,0.9465466767862951,0.9629915614141525,584,2510,9223,8908,-315,1747659700.0,000071_1747659556.pkl,163.17737650871277,30
2002170_PBU 02-03B_Gamma Ray Log Scan (TVD)_003.jpg,0.9960611057089305,421927,1677,0,2150,0.5617977528089888,1.0,0.7194244604316548,0,13690,2150,3827,1677,1747660230.0,000071_1747659556.pkl,121.04104614257812,29
1770670 Core Gamma Correlation Scan_000.jpg,1.0,431002,0,0,13178,1.0,1.0,1.0,0,0,13178,13178,0,1747660352.0,000071_1747659556.pkl,38.264639377593994,0
|1930430 Dual Prop, Resistivity, Gamma Ray Log Scan_002.jpg|,0.9979892777064673,414329,762,98,12518,0.9426204819277109,0.9922320862396956,0.9667902378745753,128,2178,12616,13280,664,1747660621.0,000072_1747660423.pkl,0,0
3H-33A_LDL_10DEC23_img_002.jpg,0.9980948407731887,704780,1368,2,12950,0.904455929599106,0.9998455836936381,0.9497616428309498,4,33264,12952,14318,1366,1747660860.0,000072_1747660423.pkl,253.45941185951233,44
|1920200 Dual Prop, Resistivity, Gamma, Directional Log Scan_004.jpg|,1.0,636339,0,0,48235,1.0,1.0,1.0,0,0,48235,48235,0,1747661118.0,000072_1747660423.pkl,0,0
|1930650 Dual Prop, Resistivity, Gamma Ray Log B&W_001.jpg|,1.0,417617,0,0,10090,1.0,1.0,1.0,0,0,10090,10090,0,1747661413.0,000072_1747660423.pkl,0,0
T19980 LDL_01AUG10_002.jpg,0.9962899110406179,700395,2200,490,21965,0.9089592385681771,0.9781785793809842,0.9422994422994423,594,35808,22455,24165,1710,1747661429.0,000072_1747660423.pkl,285.91118359565735,71
|1930650 Dual Prop, Resistivity, Gamma Ray Log B&W_004.jpg|,1.0,408520,0,0,19187,1.0,1.0,1.0,0,0,19187,19187,0,1747661765.0,000072_1747660423.pkl,0,0
|1920200 Dual Prop, Resistivity, Gamma, Directional Log Scan_001.jpg|,0.9997209943702214,682630,191,0,1753,0.9017489711934157,1.0,0.9483364890451718,0,2364,1753,1944,191,1747661784.0,000072_1747660423.pkl,0,0
|1930650 Dual Prop, Resistivity, Gamma Ray Log B&W_002.jpg|,0.9987772002796307,413656,42,481,13528,0.9969049373618276,0.9656649296880577,0.98103629573226,560,118,14009,13570,-439,1747661839.0,000072_1747660423.pkl,0,0
CD3-130 PB2  EcoScope 2MD Recorded Mode Log_001.jpg,1.0,766009,0,0,27872,1.0,1.0,1.0,0,0,27872,27872,0,1747662022.0,000072_1747660423.pkl,0,0
ODSN-24 PB1 2in TVD_000.jpg,1.0,672260,0,0,139,1.0,1.0,1.0,0,0,139,139,0,1747662042.0,000072_1747660423.pkl,0,0
3H-33A_LDL_10DEC23_img_003.jpg,1.0,714647,0,0,4453,1.0,1.0,1.0,0,0,4453,4453,0,1747662067.0,000072_1747660423.pkl,0,0
ODSN-24 PB1 2in TVD_004.jpg,0.9970999361985964,648441,1335,615,22008,0.9428094075311657,0.9728152764885294,0.9575773397728756,873,3046,22623,23343,720,1747662081.0,000072_1747660423.pkl,665.5459461212158,119
|1930270 Dual Prop, Resistivity, Gamma Ray Log Scan_002.jpg|,1.0,426068,0,0,2296,1.0,1.0,1.0,0,0,2296,2296,0,1747662751.0,000072_1747660423.pkl,0,0
1780180 PRUDHOE BAY UNIT 04-12 TEMP LOG_002.jpg,1.0,444003,0,0,219,1.0,1.0,1.0,0,0,219,219,0,1747662783.0,000072_1747660423.pkl,0,0
T19972 LDL_04AUG10_001.jpg,1.0,369091,0,0,37952,1.0,1.0,1.0,0,0,37952,37952,0,1747662790.0,000072_1747660423.pkl,0,0
|1920950 Dual Prop, Resistivity, Gamma Ray Log Scan_003.jpg|,0.9781543187994801,390856,7763,1481,23050,0.748060883393373,0.9396274102156456,0.8329719572130674,1709,78269,24531,30813,6282,1747662807.0,000072_1747660423.pkl,0,0
2002170_PBU 02-03B_Gamma Ray Log Scan (TVD)_002.jpg,0.9783208143669818,414571,9230,0,1953,0.17464007869087006,1.0,0.2973507917174178,0,219826,1953,11183,9230,1747663253.0,000072_1747660423.pkl,154.7970175743103,34
1930110 Porosity and Gamma Ray Log Scan_004.jpg,0.9942830683464451,430322,24,2470,3432,0.9930555555555556,0.5814977973568282,0.7334900619790554,2569,24,5902,3456,-2446,1747663411.0,000072_1747660423.pkl,444.4411928653717,108
T19982 PlugSetting_03JUL10_001.jpg,1.0,728755,0,0,1395,1.0,1.0,1.0,0,0,1395,1395,0,1747663914.0,000072_1747660423.pkl,0,0
1900770 Resistivity-Gamma-Dual Prop Survey Scan_000.jpg,0.9984112341123411,668121,1075,10,13714,0.9273108391371966,0.9992713494607987,0.9619471819871638,14,6761,13724,14789,1065,1747663932.0,000072_1747660423.pkl,44.999645709991455,7
|1920270 Density, Porosity, Resistivity, Gamma Ray Log Scan B&W_002.jpg|,1.0,408522,0,0,19185,1.0,1.0,1.0,0,0,19185,19185,0,1747664003.0,000072_1747660423.pkl,0,0
|1901260 R, Gamma, Directional Log Scan_004.jpg|,0.9984849762092091,413607,647,0,12802,0.951892334002528,1.0,0.9753533198735286,0,1451,12802,13449,647,1747664012.0,000072_1747660423.pkl,0,0
|1920380 Dual Prop, Resistivity, Gamma Ray Log Scan_003.jpg|,1.0,427589,0,0,118,1.0,1.0,1.0,0,0,118,118,0,1747664386.0,000072_1747660423.pkl,0,0
1961900 Core Gamma Log Scan_003.jpg,1.0,404127,0,0,9963,1.0,1.0,1.0,0,0,9963,9963,0,1747664398.0,000072_1747660423.pkl,0,0
T19982 PlugSetting_03JUL10_000.jpg,1.0,728185,0,0,1965,1.0,1.0,1.0,0,0,1965,1965,0,1747664406.0,000072_1747660423.pkl,0,0
|1901260 R, Gamma, Directional Log Scan_000.jpg|,0.9997915964182683,416834,33,56,10133,0.9967538855006886,0.9945038767298067,0.9956276099238516,66,122,10189,10166,-23,1747664442.0,000072_1747660423.pkl,0,0
|1930340 Dual Prop, Resistivity, Density, Gamma Ray Log Scan_004.jpg|,1.0,401390,0,0,26317,1.0,1.0,1.0,0,0,26317,26317,0,1747664607.0,000072_1747660423.pkl,0,0
1801120 Gamma Ray Plot Scan_002.jpg,1.0,556710,0,0,1010,1.0,1.0,1.0,0,0,1010,1010,0,1747664615.0,000072_1747660423.pkl,0,0
1640150 ITKILLIK UNIT 1 TEMP LOG_000.jpg,1.0,433456,0,0,9434,1.0,1.0,1.0,0,0,9434,9434,0,1747664657.0,000072_1747660423.pkl,0,0
CD3-130PB1 VISION Resistivity 2TVD Recorded Mode Log_001.jpg,0.9911296529328703,743303,6910,132,43536,0.8630218451413393,0.9969771915361363,0.9251758505642095,146,13782,43668,50446,6778,1747664665.0,000072_1747660423.pkl,1703.6044340133667,302
1C-150 VISION Service 2 TVD Recorded Mode Log_003.jpg,1.0,783790,0,0,13655,1.0,1.0,1.0,0,0,13655,13655,0,1747666406.0,000072_1747660423.pkl,0,0
T19978 PPROF_23JUL10_001.jpg,0.9911846395362879,349192,308,3269,53000,0.9942222555713964,0.9419040679592671,0.967356288272174,3666,651,56269,53308,-2961,1747666472.0,000072_1747660423.pkl,516.6691031455994,94
MPU_B-19A_JEWELRY_26FEB24_img_003.jpg,1.0,725888,0,0,862,1.0,1.0,1.0,0,0,862,862,0,1747667061.0,000072_1747660423.pkl,0,0
1961900 Core Gamma Log Scan_000.jpg,1.0,413437,0,0,653,1.0,1.0,1.0,0,0,653,653,0,1747667127.0,000072_1747660423.pkl,0,0
CD3-130PB1 VISION Resistivity 5MD Recorded Mode Log_003.jpg,0.9994696938206103,784507,372,49,8953,0.9601072386058981,0.994556765163297,0.9770284280024009,62,2747,9002,9325,323,1747667153.0,000072_1747660423.pkl,213.87853717803955,45
|1910880 Resistivity, Gamma, Directional Survey Log Scan_003.jpg|,1.0,415266,0,0,11139,1.0,1.0,1.0,0,0,11139,11139,0,1747667394.0,000072_1747660423.pkl,0,0
1900770 Resistivity-Gamma-Dual Prop Survey Scan_001.jpg,1.0,650014,0,0,32906,1.0,1.0,1.0,0,0,32906,32906,0,1747667446.0,000072_1747660423.pkl,0,0
|1920380 Dual Prop, Resistivity, Gamma Ray Log Scan_004.jpg|,0.9991325837547667,417918,0,371,9418,1.0,0.96210031668199,0.980684125579216,561,0,9789,9418,-371,1747667455.0,000072_1747660423.pkl,0,0
2002170_PBU 02-03B_Gamma Ray Log Scan (TVD)_000.jpg,1.0,424326,0,0,1428,1.0,1.0,1.0,0,0,1428,1428,0,1747667808.0,000072_1747660423.pkl,0,0
1860310 Gamma Ray Log Scan_002.jpg,0.9988775830489215,493224,157,408,9589,0.9838908270059512,0.9591877563268981,0.9713822620675683,480,1320,9997,9746,-251,1747667819.0,000072_1747660423.pkl,174.67906188964844,29
1C-150 VISION Service 2 TVD Recorded Mode Log_001.jpg,1.0,762294,0,0,35151,1.0,1.0,1.0,0,0,35151,35151,0,1747668004.0,000072_1747660423.pkl,0,0
|1920270 Density, Porosity, Resistivity, Gamma Ray Log Scan B&W_003.jpg|,0.9990904988695533,405493,232,157,21825,0.9894817971618988,0.9928577927395141,0.9911669202297962,185,471,21982,22057,75,1747668018.0,000072_1747660423.pkl,0,0
T19980 LDL_01AUG10_000.jpg,0.999884145920971,717583,84,0,7383,0.9887505022097228,1.0,0.9943434343434344,0,227,7383,7467,84,1747668146.0,000072_1747660423.pkl,98.78873491287231,16
|1920270 Density, Porosity, Resistivity, Gamma Ray Log Scan B&W_000.jpg|,1.0,424904,0,0,2803,1.0,1.0,1.0,0,0,2803,2803,0,1747668310.0,000072_1747660423.pkl,0,0
|1930330 Dual Prop, Resistivity, Gamma Ray Log Scan_003.jpg|,0.9997105265615225,415926,93,31,12314,0.9925042314822278,0.9974888618874038,0.9949903038138332,48,230,12345,12407,62,1747668318.0,000072_1747660423.pkl,0,0
1630230 Sonic Log-Gamma Ray Scan_002.jpg,1.0,598736,0,0,19846,1.0,1.0,1.0,0,0,19846,19846,0,1747668389.0,000072_1747660423.pkl,0,0
1900770 Resistivity-Gamma-Dual Prop Survey Scan_002.jpg,1.0,672357,0,0,10563,1.0,1.0,1.0,0,0,10563,10563,0,1747668457.0,000072_1747660423.pkl,0,0
T19982 Stage1Jewelry_16JUL10_002.jpg,0.9921114986680796,401585,300,2916,2881,0.9056900345803206,0.4969811971709505,0.6417910447761195,2971,1488,5797,3181,-2616,1747668465.0,000072_1747660423.pkl,484.40147709846497,64
T19982 Stage1Jewelry_16JUL10_003.jpg,0.9964776467933341,402137,0,1436,4109,1.0,0.7410279531109107,0.8512533664802154,1509,0,5545,4109,-1436,1747668953.0,000072_1747660423.pkl,144.41051959991455,20
CD3-130 PB2  EcoScope 2MD Recorded Mode Log_004.jpg,0.9984909577128058,769729,1198,0,22954,0.9503974826101358,1.0,0.9745679955844266,0,1948,22954,24152,1198,1747669103.0,000072_1747660423.pkl,254.35979628562927,36
1780180 PRUDHOE BAY UNIT 04-12 TEMP LOG_001.jpg,1.0,434734,0,0,9488,1.0,1.0,1.0,0,0,9488,9488,0,1747669492.0,000073_1747669478.pkl,0,0
1770670 Core Gamma Correlation Scan_001.jpg,1.0,443422,0,0,758,1.0,1.0,1.0,0,0,758,758,0,1747669500.0,000073_1747669478.pkl,0,0
T19980 LDL_01AUG10_003.jpg,1.0,722036,0,0,3014,1.0,1.0,1.0,0,0,3014,3014,0,1747669508.0,000073_1747669478.pkl,0,0
|1930330 Dual Prop, Resistivity, Gamma Ray Log Scan_004.jpg|,1.0,425794,0,0,2570,1.0,1.0,1.0,0,0,2570,2570,0,1747669516.0,000073_1747669478.pkl,0,0
|1930270 Dual Prop, Resistivity, Gamma Ray Log Scan_004.jpg|,1.0,425990,0,0,2374,1.0,1.0,1.0,0,0,2374,2374,0,1747669566.0,000073_1747669478.pkl,0,0
|1930430 Dual Prop, Resistivity, Gamma Ray Log Scan_001.jpg|,0.9954337899543378,392095,1800,153,33659,0.9492371471276686,0.9954749792972909,0.9718063836237387,188,3704,33812,35459,1647,1747669574.0,000073_1747669478.pkl,0,0
1930110 Porosity and Gamma Ray Log Scan_002.jpg,0.9907392125579946,388589,1128,2912,43619,0.9747916061411939,0.937418065375771,0.9557396086680251,3294,3496,46531,44747,-1784,1747669937.0,000074_1747669836.pkl,465.1880683898926,90
SCU 31-04 PB1 TC TVD_004.jpg,0.9902245433625773,647455,6525,0,13508,0.6742874257475165,1.0,0.8054619719149697,0,49001,13508,20033,6525,1747670436.0,000074_1747669836.pkl,359.13127636909485,61
1C-150 VISION Service 2 TVD Recorded Mode Log_002.jpg,1.0,790959,0,0,6486,1.0,1.0,1.0,0,0,6486,6486,0,1747670801.0,000074_1747669836.pkl,0,0
T19972 LDL_04AUG10_004.jpg,0.9994619733050316,383221,185,34,23603,0.9922229695644863,0.9985615771883065,0.9953821823932525,98,7976,23637,23788,151,1747670810.0,000074_1747669836.pkl,88.35358786582947,17
T19982 PlugSetting_03JUL10_004.jpg,0.999798671505855,718677,34,113,11326,0.9970070422535211,0.990121514118367,0.9935523487872275,182,78,11439,11360,-79,1747670910.0,000074_1747669836.pkl,49.67408800125122,4
1961900 Core Gamma Log Scan_004.jpg,0.9928614552391992,391903,399,2557,19231,0.9796739684156903,0.8826418211859739,0.9286300642232845,3421,4320,21788,19630,-2158,1747670971.0,000074_1747669836.pkl,216.92995285987854,45
1930110 Porosity and Gamma Ray Log Scan_003.jpg,0.9974372375346133,429521,1118,0,5609,0.8338040731381002,1.0,0.9093709468223087,0,2822,5609,6727,1118,1747671193.0,000074_1747669836.pkl,189.9934265613556,38
T19972 LDL_04AUG10_002.jpg,0.999488997476925,399453,0,208,7382,1.0,0.9725955204216074,0.9861074004808977,252,0,7590,7382,-208,1747671412.0,000074_1747669836.pkl,49.127413511276245,13
T19972 LDL_04AUG10_000.jpg,0.9999213842272192,402769,0,32,4242,1.0,0.9925128685072532,0.9962423673085955,89,0,4274,4242,-32,1747671514.0,000074_1747669836.pkl,11.389788150787354,3
T19978 PPROF_23JUL10_004.jpg,1.0,397107,0,0,8662,1.0,1.0,1.0,0,0,8662,8662,0,1747671554.0,000074_1747669836.pkl,0,0
|1920950 Dual Prop, Resistivity, Gamma Ray Log Scan_000.jpg|,1.0,422421,0,0,729,1.0,1.0,1.0,0,0,729,729,0,1747671562.0,000074_1747669836.pkl,0,0
|1920200 Dual Prop, Resistivity, Gamma, Directional Log Scan_002.jpg|,0.9950582405992632,668184,1439,1944,13007,0.9003876505607088,0.8699752524914721,0.8849202299554375,2329,31415,14951,14446,-505,1747671570.0,000074_1747669836.pkl,0,0
|1921440 Dual Prop, Resistivity, Gamma Ray Log Scan_000.jpg|,1.0,413665,0,0,7532,1.0,1.0,1.0,0,0,7532,7532,0,1747671840.0,000076_1747671821.pkl,0,0
1630230 Sonic Log-Gamma Ray Scan_003.jpg,0.9367909185847633,574975,38733,367,4507,0.10423219241443109,0.9247025030775544,0.18734671821091575,427,472562,4874,43240,38366,1747671848.0,000077_1747671847.pkl,198.8449342250824,56
1920280_M-26A_Density-Neutron Log Scan_Color_003.jpg,1.0,377083,0,0,26765,1.0,1.0,1.0,0,0,26765,26765,0,1747672127.0,000078_1747672127.pkl,0,0
1920280_M-26A_Density Log Scan_Color_002.jpg,1.0,441369,0,0,59859,1.0,1.0,1.0,0,0,59859,59859,0,1747672137.0,000078_1747672127.pkl,0,0
1780180 PRUDHOE BAY UNIT 04-12 TEMP LOG_000.jpg,0.9957791374582978,436455,442,1433,5892,0.9302178718029681,0.8043686006825939,0.8627278717329233,1472,14142,7325,6334,-991,1747672147.0,000078_1747672127.pkl,87.14593505859375,10
$R14BIPP_001.jpg,0.9978419806082202,407630,923,0,19154,0.9540269960651492,1.0,0.9764726874155641,0,4360,19154,20077,923,1747672239.0,000080_1747672205.pkl,84.93601107597351,15
1890990 Resistivity-Gamma-Directional Survey Log Scan_001.jpg,0.9998391698366524,422521,69,0,6434,0.9893895125326773,1.0,0.9946664605395378,0,404,6434,6503,69,1747672352.0,000082_1747672334.pkl,64.73241949081421,8
|1930340 Dual Prop, Resistivity, Density, Gamma Ray Log Scan_000.jpg|,0.9963877140191767,406151,784,761,20011,0.96229862947824,0.9633641440400539,0.962831091971997,834,1819,20772,20795,23,1747672420.0,000082_1747672334.pkl,0,0
|1930270 Dual Prop, Resistivity, Gamma Ray Log Scan_000.jpg|,1.0,415503,0,0,12861,1.0,1.0,1.0,0,0,12861,12861,0,1747672617.0,000082_1747672334.pkl,0,0
T19978 PPROF_23JUL10_000.jpg,0.9997363031675658,382343,30,77,23319,0.9987151484003598,0.996708839117798,0.9977109851320998,99,70,23396,23349,-47,1747672746.0,000082_1747672334.pkl,59.35106563568115,13
|1920270 Density, Porosity, Resistivity, Gamma Ray Log Scan B&W_004.jpg|,0.9969862546088795,423230,1250,39,3188,0.7183415953132042,0.9879144716454912,0.8318330071754729,46,16125,3227,4438,1211,1747672838.0,000083_1747672824.pkl,0,0
1860310 Gamma Ray Log Scan 3_003.jpg,1.0,453337,0,0,58597,1.0,1.0,1.0,0,0,58597,58597,0,1747672905.0,000083_1747672824.pkl,0,0
T19982 Stage1Jewelry_16JUL10_001.jpg,0.9983344861926697,401213,12,667,5790,0.9979317476732161,0.8967012544525321,0.9446121217065013,745,17,6457,5802,-655,1747672913.0,000083_1747672824.pkl,77.27490234375,12
|1920370 Dual Prop, Resistivity, Gamma Ray Log Scan_003.jpg|,1.0,739949,0,0,25676,1.0,1.0,1.0,0,0,25676,25676,0,1747673005.0,000084_1747672953.pkl,0,0
1930110 Porosity and Gamma Ray Log Scan_001.jpg,0.9984618840659442,426615,0,671,8962,1.0,0.9303436105055538,0.9639150309222909,736,0,9633,8962,-671,1747673397.0,000084_1747672953.pkl,100.47955965995789,12
CD3-130 PB2  EcoScope 2TVD Recorded Mode Log_002.jpg,0.9985325256556083,761608,537,628,31108,0.9830304945489019,0.9802117469120242,0.9816190972057872,697,976,31736,31645,-91,1747673511.0,000084_1747672953.pkl,294.86092257499695,50
ODSN-24 PB1 2in TVD_003.jpg,1.0,672399,0,0,0,nan,nan,nan,0,0,0,0,0,1747673846.0,000085_1747673755.pkl,0,0
1860310 Gamma Ray Log Scan_000.jpg,1.0,503190,0,0,188,1.0,1.0,1.0,0,0,188,188,0,1747673920.0,000085_1747673755.pkl,0,0
CD3-130PB1 VISION Resistivity 5MD Recorded Mode Log_001.jpg,0.9909835353157463,765355,7052,106,21368,0.7518648838845883,0.9950637980814008,0.8565358560147512,121,25363,21474,28420,6946,1747673986.0,000086_1747673986.pkl,1192.2127833366394,263
SCU 31-04 PB1 TC TVD_001.jpg,0.979843832398485,638453,13454,0,15581,0.5366282073359738,1.0,0.6984489869105254,0,221386,15581,29035,13454,1747675195.0,000086_1747673986.pkl,494.2038028240204,110
1C-150 VISION Service 2 TVD Recorded Mode Log_004.jpg,1.0,787329,0,0,10116,1.0,1.0,1.0,0,0,10116,10116,0,1747675713.0,000088_1747675248.pkl,0,0
|1930340 Dual Prop, Resistivity, Density, Gamma Ray Log Scan_002.jpg|,1.0,419572,0,0,8135,1.0,1.0,1.0,0,0,8135,8135,0,1747675722.0,000088_1747675248.pkl,0,0
1801120 Gamma Ray Plot Scan_000.jpg,0.993957541418633,553617,3370,0,733,0.1786497684621009,1.0,0.3031430934656741,0,117530,733,4103,3370,1747675730.0,000088_1747675248.pkl,37.829922914505005,5
$R14BIPP_002.jpg,1.0,420703,0,0,7004,1.0,1.0,1.0,0,0,7004,7004,0,1747675796.0,000088_1747675248.pkl,9.174814939498901,0
1860310 Gamma Ray Log Scan 4_000.jpg,1.0,490128,0,0,16062,1.0,1.0,1.0,0,0,16062,16062,0,1747675806.0,000088_1747675248.pkl,9.925109624862671,0
1801120 Gamma Ray Plot Scan_004.jpg,1.0,544403,0,0,13317,1.0,1.0,1.0,0,0,13317,13317,0,1747675817.0,000088_1747675248.pkl,15.000229120254517,0
CD3-130 PB2  EcoScope 2TVD Recorded Mode Log_003.jpg,1.0,754375,0,0,39506,1.0,1.0,1.0,0,0,39506,39506,0,1747675828.0,000088_1747675248.pkl,8.76991891860962,0
3H-33A_LDL_10DEC23_img_000.jpg,0.9900375469336671,703317,7066,98,8619,0.54950589735416,0.9887576000917747,0.7064175067617408,210,61212,8717,15685,6968,1747675869.0,000088_1747675248.pkl,95.66245007514954,15
$R14BIPP_003.jpg,0.964606611535467,396177,14872,266,16392,0.5243091095189355,0.9840316964821707,0.6841116814824088,283,31362,16658,31264,14606,1747676018.0,000089_1747676000.pkl,454.6976590156555,77
1961900 Core Gamma Log Scan_002.jpg,0.9999009877079862,410472,0,41,3577,1.0,0.9886677722498618,0.9943015983321751,98,0,3618,3577,-41,1747676497.0,000090_1747676389.pkl,3.253030776977539,1
1860310 Gamma Ray Log Scan 4_001.jpg,0.9971176830834272,461944,1001,458,42787,0.9771398556682196,0.9894091802520523,0.983236243723645,530,10868,43245,43788,543,1747676531.0,000090_1747676389.pkl,288.89298462867737,58
1640150 ITKILLIK UNIT 1 TEMP LOG_003.jpg,1.0,439222,0,0,3668,1.0,1.0,1.0,0,0,3668,3668,0,1747676834.0,000090_1747676389.pkl,0,0
1860310 Gamma Ray Log Scan_004.jpg,1.0,492963,0,0,10415,1.0,1.0,1.0,0,0,10415,10415,0,1747676845.0,000090_1747676389.pkl,0,0
|1930270 Dual Prop, Resistivity, Gamma Ray Log Scan_003.jpg|,0.9997268678040171,416091,86,31,12156,0.9929750040843,0.9974563058997292,0.9952106103401694,49,1754,12187,12242,55,1747676858.0,000090_1747676389.pkl,0,0
MPU_B-19A_JEWELRY_26FEB24_img_002.jpg,1.0,715317,0,0,11433,1.0,1.0,1.0,0,0,11433,11433,0,1747676912.0,000090_1747676389.pkl,0.962132453918457,0
T19980 LDL_01AUG10_004.jpg,1.0,699009,0,0,26041,1.0,1.0,1.0,0,0,26041,26041,0,1747676952.0,000090_1747676389.pkl,9.086222887039185,0
CD3-130 PB2  EcoScope 2TVD Recorded Mode Log_000.jpg,1.0,767625,0,0,26256,1.0,1.0,1.0,0,0,26256,26256,0,1747676992.0,000090_1747676389.pkl,0,0
1630230 Sonic Log-Gamma Ray Scan_004.jpg,0.9604337015949381,590568,23065,1410,3539,0.1330251090061645,0.7150939583754293,0.22432098374164106,1461,120986,4949,26604,21655,1747677002.0,000090_1747676389.pkl,219.95808291435242,40
T19978 PPROF_23JUL10_002.jpg,1.0,397812,0,0,7957,1.0,1.0,1.0,0,0,7957,7957,0,1747677234.0,000090_1747676389.pkl,0,0
T19982 PlugSetting_03JUL10_002.jpg,1.0,678288,0,0,51862,1.0,1.0,1.0,0,0,51862,51862,0,1747677244.0,000090_1747676389.pkl,0,0
|1910880 Resistivity, Gamma, Directional Survey Log Scan_001.jpg|,1.0,424691,0,0,1714,1.0,1.0,1.0,0,0,1714,1714,0,1747677252.0,000091_1747677251.pkl,0,0
1900740 Resistivity-Gamma-Directional Survey Scan_002.jpg,1.0,421709,0,0,790,1.0,1.0,1.0,0,0,790,790,0,1747677264.0,000091_1747677251.pkl,0,0
|1910880 Resistivity, Gamma, Directional Survey Log Scan_004.jpg|,1.0,391221,0,0,35184,1.0,1.0,1.0,0,0,35184,35184,0,1747677277.0,000091_1747677251.pkl,0,0
|1920950 Dual Prop, Resistivity, Gamma Ray Log Scan_001.jpg|,1.0,423150,0,0,0,nan,nan,nan,0,0,0,0,0,1747677312.0,000091_1747677251.pkl,0,0
1770670 Core Gamma Correlation Scan_004.jpg,0.989589805934531,432531,3345,1279,7025,0.6774349083895853,0.8459778420038536,0.7523829923958445,1564,122346,8304,10370,2066,1747677322.0,000091_1747677251.pkl,412.1012728214264,69
T19982 Stage1Jewelry_16JUL10_000.jpg,1.0,399600,0,0,8082,1.0,1.0,1.0,0,0,8082,8082,0,1747677745.0,000096_1747677462.pkl,0,0
1C-150 VISION Service 2 TVD Recorded Mode Log_000.jpg,1.0,760790,0,0,36655,1.0,1.0,1.0,0,0,36655,36655,0,1747677769.0,000096_1747677462.pkl,0,0
1930110 Porosity and Gamma Ray Log Scan_000.jpg,0.9983014248775925,427909,741,0,7598,0.9111404245113323,1.0,0.9535044236681934,0,3043,7598,8339,741,1747677779.0,000097_1747677776.pkl,51.59401607513428,12
|1901260 R, Gamma, Directional Log Scan_001.jpg|,1.0,427008,0,0,48,1.0,1.0,1.0,0,0,48,48,0,1747677857.0,000097_1747677776.pkl,0,0
3H-33A_LDL_10DEC23_img_001.jpg,0.9999346405228758,712057,32,15,6996,0.9954467842914058,0.9978605049208387,0.9966521832039318,20,438,7011,7028,17,1747677867.0,000097_1747677776.pkl,53.726295948028564,9
MPU_B-19A_JEWELRY_26FEB24_img_001.jpg,0.9999903680770554,713533,0,7,13210,1.0,0.9994703790572748,0.999735119385477,8,0,13217,13210,-7,1747677933.0,000097_1747677776.pkl,4.444293260574341,3
1630230 Sonic Log-Gamma Ray Scan_001.jpg,0.9951809137672936,615260,230,2751,341,0.5971978984238179,0.11028460543337645,0.18618618618618618,2765,22298,3092,571,-2521,1747677970.0,000097_1747677776.pkl,228.93784141540527,29
MPU_B-19A_JEWELRY_26FEB24_img_000.jpg,1.0,726663,0,0,87,1.0,1.0,1.0,0,0,87,87,0,1747678204.0,000097_1747677776.pkl,0,0
